20 20
########0###########
#      # ####    # #
#  ### # ###   #   #
#  #   # #   #######
#  # # # #   #     #
#  ##### ##  #     #
#      # #  ##     #
# ###  # #         #
# # #  # #  #####  #
# # #  # ##  #     #
# #    # #  ##  #  #
# ###### ##  #  #  #
#        #  ##  #  #
######## ##  #  #  #
#      # ########  #
#      #           #
#      # ###########
######## ##### #####
#                 1#
####################
