15 15
XXXXXXXXXXXXXXX
X            X 
X XXXXXXXXXX X 
X            X 
X X X   X    X 
X X X   X XXX  
X X X   X     X
X X X 0 XXXXXXX
XXXXXX   X XX X
X          XX X
XXXX X XXXXXX X
X    X        X
XXXX XXXX XXX X
X1      X   X X
XXXXXXXXXX XXXX
