10 10
        1X
 XXXXXXXX 
   X  X X 
XX X XX X 
   X    X 
 XX  XX X 
 XX XXXXX 
 XX    X  
 X  XX   X
0  XX  XXX
